###################################
#                                 #
#                                 #
#                                 #
#                                 #
#                                 #
#                                 #
#                                 #
#                                 #
#                                 #
#                                 #
#                                 #####
#                                     #
#                                     -
-  @                                  -
-  @                             ######
######################--###########