##########--##########
#....................#
##........*.........##
#.....__________.....#
##..._.........._...##
#..._..._...._..._...#
#..._..._...._..._...#
#..._............_...#
##.._...______..._..##
#...._..........._...#
##....__________....##
-....................-
-....................-
######################
