#############--############
#.........................#
#.........................#
#............#............#
#...........###...........#
#..........#####..........#
#.........#######.........#
-........#########........-
-......#############......-
####################--#####