#########--#########

#..................#

#..................#

#....._______......-

#..................-

#................###

###................#

#............#.....#

#..................#

#........#.........#

-..................#

-....#.............#

###########--#######
