#################--#################
#.................................#
#................__................#
#.................................#
#.............###__###.............#
#............####..####............#
#...........#####__#####...........#
-..........######..######..........-
-.........#######__#######.........-
#################--################
