########--#######
#...............#
#...............#
#_______________#
#...............#
#...............#
#.......*.......#
#......###......#
-.......#.......-
-.......#.......-
#########--######