###########--###########

#......................#

-......................-

-........______........-

#####.............######

######...........#######

#######.........########

########.......#########

#########.....##########

###########--###########
