############--#########

#.....................#

#...........__........#

#.....................#

#.....__.........__...#

#.....................#

#.....................#

-.....................-

-.....***.......***...-

############--#########
