#########--#########

#..................#

#..................#

#..................#

#.....########.....#

#..................-

#..................-

###..............###

#.._............_..#

#..................#

#.....########.....#

-..................#

-..................#

#########--#########
