###########--###########
#......................#
#......................#
#......................-
#......................-
###........**........###
#........______........#
#.._................_..#
#......................#
#......................#
#################......#
#......................#
#......................#
-......................#
-.................***..#
##############--########