###########--###########
#......................#
#......................#
#.........____.........-
#......................-
###..................###
#........______........#
#.._................_..#
#......................#
#..........**..........#
#################......#
#......................#
#..................___.#
-......................#
-......................#
##############--########