####--####
#........#
#........#
#...*....#
#######..#
#........#
#........-
#........-
#..#######
#........#
#........#
#........#
#######..#
#........#
-........#
-........#
#####--###