########--######
#..............#
#..............#
#______________#
#..............#
#..............#
#......###.....#
-.......#......-
-.......#......-
#########--#####