############--#############
#.........................#
#...........__............#
-.........................-
-.........................-
############--#############
