############--############
#........................#
#........................#
#........................#
#________________________#
#........................#
#........................#
#........................#
#.**..................**.#
##########......##########
#........................#
-........................-
-........................-
############--############
