#################--#
#..................#
#..................#
#................__#
#..................#
#..................#
#....#...#.....#...#
-....#...#.....#...-
-....#...#.....#...-
##########--########