#######--###########

#..................#

#..................-

#..................-

#......#############

#..................#

#..................#

#..................#

#############......#

#..................#

-..................#

-..................#

############--######
