#########--#########
#..................#
#..................#
##.......__.......##
#..................-
#..................-
##___....__....___##
#..................#
#..................#
##.......__.......##
#..................#
-..................#
-....**......**....#
#########--#########
