#########--#########
#..................#
#..................#
#........*.........#
#######______#######
#..................#
#..................#
#..................#
#######______#######
#..................#
-..................-
-..................-
#########--#########
