######################
#....................#
#....................#
#....................#
#..____........____..#
#.......B............#
#....................#
#..____........____..#
#....................#
#....................#
#..____........____..#
#....................#
#....................#
#....................#
#...*............*...#
######################