#######################
#.....................#
#.....................#
#.....................#
#.....................#
#..___...........___..#
#.....................#
#.....................#
#.....................#
#..___...........___..#
#.....................#
#.....................#
#.....................#
#..___...........___..#
#.....................#
-.....................#
-.....................#
#####--################