###################################
#                                 #
#                                 #
#                                 #
#                                 #
#                                 #
#                                 #
#                                 #
#                                 ####
#                                    #
#                                    -
#                                  g -
#                           /#########
#                          /#######
# @      v                /########
# @      v               /#########
###################################