###################################
#                                 #
#                                 #
#                                 #
#                                 #
#                                 #
#                                 #
#                                 #
#                                 ####
#                                    #
#                                    -
#                                    -
#                           ##########
#                          ########
# @         v             #########
# @         v            ##########
###################################