###################################
#                                 #
#                                 #
#                                 #
#                                 #
#                                 #
#                                 #
#                                 #
#                                 ####
#                                    #
#                             @      -
#                             @      -
#                           /#########
#                          /#######
#\                        /########
# \                      /#########
###################################