########################
#......................#
#......................#
#......................#
#......................#
###........**........###
#........______........#
#.._................_..#
#......................#
#......................#
#################......#
#......................#
#......................#
#......................#
#.................***..#
########################