################--################
#................................#
#................................#
#...............*................#
#________________________________#
#................................#
#................................#
#................................#
#................................#
#....*..........**..........*....#
#________________________________#
#................................#
-................................-
-................................-
#################--###############
