###################--##################
#.....................................#
#.....................................#
#..................*..................#
###............._______.............###
#.....................................#
#.....................................#
#.....................................-
#..................#..................-
#.......#######.........#######.......#
#..........#...............#..........#
#..........#...............#..........#
-.....................................#
-.....**.......**.....**.......**.....#
##########################--###########
