##############--#############
#...........................#
#.............__............#
#...........................#
#..........._____...........#
#...........................#
#...........................#
########.............########
#...........*...*...........#
#.........._______..........#
#...........................#
-...........................-
-..........**...............-
##############--#############
