#############################
#...........................#
#...........................#
#...........................#
#..........._____...........#
#...........................#
#...........................#
########.............########
#...........................#
#..........._____...........#
#...........................#
#...........................#
#...........................#
#############################
