############--############
#........................#
#........................#
#...........*............#
#________________________#
#........................#
#........................#
#........................#
#*......................*#
#_......................_#
#........................#
##########......##########
#........................#
-........................-
-........................-
############--############
