###########--###########
#......................#
-..........*...........-
-........______........-
####\............./#####
#####\.........../######
######\........./#######
#######\......./########
########\...../#########
###########--###########
