#######--############
#.........#
#.....____#
#.........#
#.....__..#
-.........-
-...__....-
#.........#
#.........#
#.........#
#....*....#
##--#######