####################
#..................#
#..................#
#....._______......#
#..................#
#................###
###................#
#............#.....#
#..................#
#........#.........#
#..................#
#....#.............#
####################
