#########--#########
#..................#
#..................#
#........*.........#
#.....########.....#
#..................-
#..................-
###..............###
#..................#
#..................#
#.....########.....#
-..................#
-..................#
#########--#########
