###################--###################
#                                      #
#       _________________________      #
#                                      #
#                                      #
#        *                     *       #
#       ___                   ___      #
#             _____________            #
#                                      #
-       ########        ########       -
-     ###      ###    ###      ###     -
#######          ##--##          #######