######################--#########################
#...............................................#
#...............................................#
#...............................................#
#...............................................#
#.....................*.........................#
#......___________________________________......#
#...............................................#
-...............................................-
-...............................................-
######################--#########################