###################################
#                                 #
#                                 #
#                                 #
#                                 #
#                                 #
#                                 #
#                                 #
#                                 #
#                                 #
#                                 #
#                                 #####
#                                     #
#                                     -
#  @                                  -
#  @                             ######
######################--###########