#######--########
#...............-
#...............-
#_______________#
#...............#
#...............#
-...............#
-_______________#
#...............#
#...............#
##########--#####