######################--###############

#.....................................#

#.....................................#

#.....................__..............#

#.....................................#

#.....................................#

#......_________________________......#

#.....................................#

-.....................................-

-................*............*.......-

######################--###############