###########################
#.........................#
#...........__............#
#.........................#
#.........................#
###########################
