###################--###################
#......................................#
#......._________________________......#
#......................................#
#......................................#
#........*.....................* ......#
#.......___...................___......#
#............._____________............#
#......................................#
-.......########........########.......-
-.....############....############.....-
###################--###################