########################
#......................#
#......................#
#........._____........#
####/\............./\###
#####/\.........../\####
######/\........./\#####
#######/\......./\######
########/\...../\#######
########################
