####################
#..................#
#..................#
#..................#
#.....########.....#
#..................#
#..................#
###..............###
#..................#
#..................#
#.....########.....#
#..................#
#..................#
####################
