#########--#########
#..................#
#..................#
##.......__.......##
#..................-
#..................-
##.......__.......##
#..................#
#..................#
##.......__.......##
#..................#
-..................#
-..................#
#########--#########
