#######################################
#.....................................#
#.....................................#
#.....................................#
###............._______.............###
#.....................................#
#.....................................#
#.....................................#
#..................#..................#
#.......#######.........#######.......#
#..........#...............#..........#
#..........#...............#..........#
#.....................................#
#.....**.......**.....**.......**.....#
#######################################
