#######--##
#.........#
#.....____#
#.........#
#.....__..#
-.........-
-...__....-
#.........#
#.........#
#.........#
#\...*.../#
##--#######