####################
#..................#
#..................#
#..................#
#......#############
#..................#
#..................#
#..................#
#############......#
#..................#
#..................#
#..................#
####################
