###############--##############
#.............................#
#.............____............#
#.............................#
#........./\###_###/\.........#
#......../\####.####/\........#
#......./\#####_#####/\.......#
-....../\######.######/\......-
-...../\#######_#######/\.....-
###############--##############
