####################
#..................#
#..................#
#..................#
#######______#######
#..................#
#..................#
#..................#
#######______#######
#..................#
#..................#
#..................#
####################
