##############--#############
#...........................#
#...........................#
#.............**............#
#..........._____...........#
#...........................#
#...........................#
########.............########
#............**.............#
#..........._____...........#
#...........................#
-...........................-
-...........................-
##############--#############
