#################################################
#...............................................#
#...............................................#
#...............................................#
#...............................................#
#...............................................#
#......___________________________________......#
#...............................................#
#...............................................#
#...............................................#
#################################################