##################################
#................................#
#................................#
#................................#
#________________________________#
#................................#
#................................#
#................................#
#................................#
#....*..........**..........*....#
#________________________________#
#................................#
#................................#
#................................#
##################################
