##########################
#........................#
#........................#
#........................#
#________________________#
#........................#
#........................#
#........................#
#*......................*#
#_......................_#
#........................#
##########......##########
#........................#
#........................#
#........................#
##########################
