###############################
#.............................#
#.............................#
#.............................#
#........./\#######/\.........#
#......../\#########/\........#
#......./\###########/\.......#
#....../\#############/\......#
#...../\###############/\.....#
###############################
