.........................
.........................
........#................
....#....................
.........................
#........###.............
..............#..........
..................#......
.#.......................
.....................###.
.....#......___..........
...........#.............
.................#......#
........................#
################........#
.........#......___..####
.........#..............#
.........#..............#
.........#.........#.....#
.........#####..........#
.........#......___.....#
.....................####
@.......................#
@................*......#
#########################