##########################
#........................#
#........#...............#
#....#...................#
#........................#
##........###............#
#..............#.........#
#..................#.....#
#.#......................#
#.....................####
#.....#......___.........#
#....@......#............#
#....@............#......#
#........................#
#################........#
#.........#......___..####
#.........#..............#
#.........#..............#
#.........#.........#....#
#.........#####..........#
#.........#......___.....#
#.....................####
#........................#
#.................*......#
##########################