.........................
.........................
........#................
....#....................
.........................
#........###.............
..............#..........
..................#......
.#.......................
.....................###.
.....#...................
...........#.............
.................#......#
........................#
################........#
.........#...........####
.........#..............#
.........#..............#
.........#.........#....#
.........#####..........#
.........#..............#
.....................####
@.......................#
@.......................#
#########################