#############--###########
#........................#
#........#......@........#
#....#..........@........#
#........................#
##........###............#
#..............#.........#
#..................#.....#
-.#......................#
-.....................####
#.....#......___.........#
#...........#............#
#.................#......#
#........................-
#################........-
#.........#......___..####
#.........#..............#
#.........#..............#
#.........#.........#....#
#.........#####..........#
#.........#......___.....#
#.....................####
#........................#
#.................*......#
#############--###########